1,Anthony Barela,44382,1036,-34,53,47,55,155,"$10,000"
2,Gannon Buhr,75412,1046,-33,54,54,48,156,"$5,500"
3,Ezra Aderhold,121715,1027,-30,54,52,53,159,"$3,725"
4,Matthew Orum,18330,1044,-25,57,54,53,164,"$2,975"
5,Calvin Heimburg,45971,1051,-24,54,57,54,165,"$2,450"
6,Gavin Rathbun,60436,1019,-23,56,56,54,166,"$2,000"
7,Braeden Sides,129963,1019,-21,57,55,56,168,"$1,625"
7,Nathan Queen,68286,1020,-21,55,57,56,168,"$1,625"
7,Mason Ford,72844,1032,-21,54,56,58,168,"$1,625"
10,Kyle Klein,85132,1038,-20,59,57,53,169,"$1,350"
11,Jesse Nieminen,58923,1028,-19,62,55,53,170,"$1,071"
11,Paul Ulibarri,27171,1021,-19,58,57,55,170,"$1,071"
11,Benjamin Callaway,39015,1027,-19,57,57,56,170,"$1,071"
11,Jake Hebenheimer,43762,1015,-19,56,57,57,170,"$1,071"
11,Adam Hammes,57365,1030,-19,58,54,58,170,"$1,071"
11,Randon Latta,51685,1004,-19,56,55,59,170,"$1,071"
17,Richard Wysocki,38008,1045,-18,58,57,56,171,$813
17,Väinö Mäkelä,59635,1031,-18,58,57,56,171,$813
17,Robert Burridge,96512,1021,-18,55,57,59,171,$813
20,Ezra Robinson,50671,1039,-17,57,57,58,172,$735
20,Alden Harris,98091,1030,-17,59,53,60,172,$735
22,Andrew Marwede,75590,1027,-16,60,59,54,173,$642
22,Paul Oman,34344,1017,-16,59,58,56,173,$642
22,Luke Humphries,69424,1022,-16,58,57,58,173,$642
22,AJ Carey,61770,1011,-16,56,59,58,173,$642
22,Isaac Robinson,50670,1040,-16,57,57,59,173,$642
27,Randy Dueck,139619,1006,-15,63,56,55,174,$549
27,Aaron Gossage,35449,1029,-15,62,57,55,174,$549
27,Silas Schultz,79047,1016,-15,58,59,57,174,$549
27,Simon Lizotte,8332,1038,-15,57,57,60,174,$549
31,Jeremy Koling,33705,1023,-14,62,57,56,175,$498
31,Gavin Babcock,80331,1022,-14,62,54,59,175,$498
31,Chris Clemons,50401,1026,-14,56,59,60,175,$498
34,Jared Stoll,68103,1006,-13,65,53,58,176,$460
34,Joseph Anderson,122356,1031,-13,59,59,58,176,$460
34,Emerson Keith,47472,1020,-13,58,59,59,176,$460
37,Charlie Moore,78268,1007,-12,61,59,57,177,$435
37,Corey Ellis,44512,1033,-12,61,57,59,177,$435
39,Andrew Miranda,118426,1009,-11,63,58,57,178,$394
39,Joey Temali,100818,1007,-11,64,56,58,178,$394
39,Evan Smith,101574,1025,-11,62,57,59,178,$394
39,Bradley Williams,31644,1032,-11,63,55,60,178,$394
39,Evan Scott,89394,1021,-11,62,56,60,178,$394
39,Nikko Locastro,11534,1029,-11,60,57,61,178,$394
39,Jaden Rye,153363,1002,-11,59,56,63,178,$394
46,Chandler Kramer,139228,1019,-10,62,59,58,179,$354
46,Gregg Barsby,15857,1021,-10,61,59,59,179,$354
46,Andrew Presnell,63765,1031,-10,63,56,60,179,$354
46,Zachary Nash,101197,1014,-10,58,59,62,179,$354
50,Eric Oakley,53565,1022,-9,65,61,54,180,$48
50,Seth Talbott,114877,1012,-9,65,61,54,180,$48
50,Carter Ahrens,88279,1008,-9,61,63,56,180,$48
50,Chandler Fry,25541,1015,-9,66,56,58,180,$48
50,Zach Arlinghaus,65266,1019,-9,59,63,58,180,$48
50,Max Regitnig,27812,1010,-9,62,59,59,180,$48
50,Gavin Phillips,119504,1000,-9,60,57,63,180,$48
57,Calvin Lonnquist,145206,1021,-8,61,61,59,181,
57,Albert Tamm,76669,1022,-8,59,60,62,181,
57,G.T. Hancock,49885,1009,-8,60,57,64,181,
60,Casey White,81739,1020,-7,66,62,54,182,
60,Fredy Meza,100497,1014,-7,61,60,61,182,
62,Parker Welck,39491,1018,-6,66,59,58,183,
62,Paul Krans,132521,1022,-6,65,59,59,183,
62,Clint Calvin,84958,1015,-6,67,56,60,183,
62,Garrett Gurthie,13864,1028,-6,61,61,61,183,
62,Chris Harris,37146,1003,-6,64,57,62,183,
67,Luke Samson,59419,1014,-5,67,61,56,184,
67,Joshua Patin,56037,1011,-5,65,60,59,184,
67,Jake Wolff,144536,1007,-5,63,60,61,184,
67,Clay Edwards,91397,1012,-5,62,61,61,184,
67,Austin Turner,54049,1022,-5,62,60,62,184,
67,Thunder Schultz,56016,1004,-5,62,59,63,184,
67,Trevon Crowe,67172,998,-5,59,62,63,184,
67,Silver Lätt,61186,1014,-5,61,59,64,184,
67,Drew Gibson,48346,1023,-5,64,55,65,184,
67,Niklas Anttila,91249,1042,-5,61,57,66,184,
67,Linus Carlsson,82098,1007,-5,59,59,66,184,
78,Austin Hannum,68835,1014,-4,65,61,59,185,
78,Kevin Jones,41760,1026,-4,66,59,60,185,
78,Nick Newton,47689,1006,-4,66,58,61,185,
78,Noah Meintsma,56555,1000,-4,63,59,63,185,
78,Colten Montgomery,35876,1009,-4,62,60,63,185,
78,Tuomas Hyytiäinen,65715,1014,-4,62,60,63,185,
84,Hjalte Jensen,129061,1011,-3,57,67,62,186,
84,Luke Taylor,102119,1031,-3,66,57,63,186,
84,Tristan Tanner,99053,1010,-3,65,58,63,186,
87,Kevin Kiefer III,97115,1017,-2,67,64,56,187,
87,Brodie Smith,128378,1016,-2,68,61,58,187,
87,Blake Whitehead,145870,1004,-2,62,62,63,187,
90,Hayden Frederiksen,205985,990,-1,67,61,60,188,
90,Corbin Milchesky,153445,1000,-1,67,60,61,188,
90,James Conrad,17295,1027,-1,63,60,65,188,
90,Waden Sides,212153,1004,-1,59,62,67,188,
94,Andrew Fish,58320,1016,E,68,62,59,189,
94,Connor Rock,73695,1011,E,67,63,59,189,
96,Jake Brown,140954,1008,+1,67,63,60,190,
96,Raven Newsom,88212,1015,+1,63,66,61,190,
96,John Jones,43834,1005,+1,64,61,65,190,
96,Connor O'Reilly,99648,1009,+1,64,61,65,190,
96,Aidan Scott,99246,1015,+1,62,63,65,190,
96,Landen Sides,214321,963,+1,63,58,69,190,
102,Chris Runyan,93197,961,+2,66,64,61,191,
102,Huntington Coats,88857,966,+2,64,64,63,191,
102,Mason Marchbanks,79753,1017,+2,65,61,65,191,
102,Joshua Ianno,131072,986,+2,63,62,66,191,
106,Zach Melton,38631,996,+6,65,64,66,195,
107,Ben Mueck,180838,974,+7,69,65,62,196,
107,Chris Macias,180568,981,+7,68,62,66,196,
107,Andrew Loewer,146110,984,+7,63,66,67,196,
110,Christopher Robbins,109674,1003,+8,64,64,69,197,
111,Nicholas Duran,28359,999,+11,71,66,63,200,
111,Austin Jordan,137047,967,+11,69,60,71,200,
113,Tim Barham,53332,1015,+13,72,64,66,202,
114,Cameron Cote,70895,980,+15,66,72,66,204,
114,Logan Porter,154455,988,+15,68,68,68,204,
116,John Wlascinski,187709,968,+16,68,67,70,205,
117,Brady Harbinson,150967,970,+19,71,68,69,208,
118,Andrew Yale,144790,964,+20,71,70,68,209,
119,Jim Oates,3351,967,+21,72,71,67,210,
120,Jacob Courtis,56511,1004,+22,87,68,56,211,
121,Ricky Ovaitt,48964,973,+26,72,65,78,215,
122,Scott Stokely,3140,1018,64,999,DNF,,,
122,Jeffory Roy,103224,987,75,60,999,DNF,,
