1,Calvin Heimburg,45971,1050,-28,58,62,56,176,"$9,500"
2,Gannon Buhr,75412,1049,-25,61,61,57,179,"$5,700"
3,Gavin Rathbun,60436,1022,-23,61,60,60,181,"$3,500"
4,Joseph Anderson,122356,1032,-22,66,61,55,182,"$2,750"
5,Andrew Presnell,63765,1029,-21,62,62,59,183,"$2,100"
5,Richard Wysocki,38008,1046,-21,57,62,64,183,"$2,100"
7,Chris Dickerson,62467,1041,-19,60,63,62,185,"$1,700"
8,Gavin Babcock,80331,1022,-18,63,60,63,186,"$1,500"
9,Isaac Robinson,50670,1040,-17,63,64,60,187,"$1,350"
9,Mason Marchbanks,79753,1014,-17,61,62,64,187,"$1,350"
11,Evan Scott,89394,1020,-16,63,64,61,188,"$1,100"
11,Calvin Lonnquist,145206,1015,-16,61,64,63,188,"$1,100"
11,Ezra Robinson,50671,1040,-16,60,61,67,188,"$1,100"
14,Benjamin Callaway,39015,1026,-15,65,64,60,189,$928
14,Anthony Barela,44382,1039,-15,59,68,62,189,$928
16,Kyle Klein,85132,1039,-13,64,63,64,191,$820
16,Chris Clemons,50401,1026,-13,61,64,66,191,$820
16,Andrew Marwede,75590,1028,-13,60,65,66,191,$820
19,Jared Stoll,68103,1008,-12,65,66,61,192,$725
19,Randy Dueck,139619,1008,-12,63,65,64,192,$725
21,Chandler Kramer,139228,1018,-11,69,64,60,193,$624
21,Robert Burridge,96512,1021,-11,66,65,62,193,$624
21,Garrett Gurthie,13864,1025,-11,66,63,64,193,$624
21,AJ Carey,61770,1010,-11,67,61,65,193,$624
21,Matthew Orum,18330,1045,-11,66,61,66,193,$624
21,Alden Harris,98091,1029,-11,63,63,67,193,$624
27,Paul McBeth,27523,1037,-10,65,65,64,194,$543
27,Austin Turner,54049,1022,-10,62,62,70,194,$543
29,Kevin Kiefer III,97115,1019,-9,67,64,64,195,$502
29,Jake Hebenheimer,43762,1018,-9,61,70,64,195,$502
29,Paul Ulibarri,27171,1024,-9,61,65,69,195,$502
32,G.T. Hancock,49885,1011,-8,66,65,65,196,$476
32,Emerson Keith,47472,1022,-8,63,64,69,196,$476
34,Luke Taylor,102119,1028,-7,71,62,64,197,$460
34,Nathan Queen,68286,1020,-7,65,65,67,197,$460
36,Luke Samson,59419,1014,-6,65,68,65,198,$407
36,Levi Hancock,103050,1014,-6,63,66,69,198,$407
36,Jake Monn,98722,1013,-6,63,65,70,198,$407
36,Albert Tamm,76669,1022,-6,59,69,70,198,$407
36,Zachary Nash,101197,1015,-6,62,64,72,198,$407
41,Aaron Gossage,35449,1030,-4,63,68,69,200,$270
41,Zach Arlinghaus,65266,1018,-4,66,64,70,200,$270
41,Luke Humphries,69424,1024,-4,64,65,71,200,$270
41,Ezra Aderhold,121715,1029,-4,62,67,71,200,$270
45,Logan Harpool,101319,1007,-3,70,66,65,201,
45,Linus Carlsson,82098,1008,-3,64,70,67,201,
45,Jaden Rye,153363,1002,-3,67,65,69,201,
48,Braeden Sides,129963,1020,-2,66,66,70,202,
49,Silas Schultz,79047,1018,E,68,71,65,204,
49,Elijah Bickel,94844,1002,E,69,66,69,204,
49,Caleb Bruce,101944,1000,E,67,68,69,204,
49,Ty Love,89959,1013,E,70,62,72,204,
53,Jake Brown,140954,1004,+1,67,66,72,205,
53,Wyatt Mahoney,89460,998,+1,65,68,72,205,
55,Ryan Mulder,111887,989,+2,73,67,66,206,
55,Joel Freeman,69509,1034,+2,68,68,70,206,
55,Nolan Ramser,90461,977,+2,70,63,73,206,
55,Billy Engel,44458,996,+2,66,66,74,206,
59,Connor O'Reilly,99648,1008,+3,68,65,74,207,
60,Paul Krans,132521,1021,+4,75,68,65,208,
60,John Jones,43834,1007,+4,71,70,67,208,
60,Austin Hannum,68835,1012,+4,70,68,70,208,
60,Brodie Smith,128378,1011,+4,67,69,72,208,
60,Kyle Giovannini,60367,995,+4,68,66,74,208,
65,Aidan Scott,99246,1015,+5,69,69,71,209,
65,Joe Notch,106915,1009,+5,68,67,74,209,
65,Kevin Fodrey,146804,993,+5,68,67,74,209,
68,Corbin Milchesky,153445,999,+6,73,71,66,210,
68,Colten Montgomery,35876,1010,+6,66,76,68,210,
68,Nate Metzler,41220,1004,+6,73,68,69,210,
68,Dillon Spellman,103705,967,+6,70,71,69,210,
68,Kevin Jones,41760,1022,+6,67,70,73,210,
73,Scott Withers,38464,1026,+7,74,70,67,211,
73,Anthony Bodanza,210763,987,+7,75,68,68,211,
73,Jonathan Fletcher,65940,992,+7,70,72,69,211,
73,Charlie Moore,78268,1006,+7,66,71,74,211,
73,JohnE McCray,9852,1020,+7,66,69,76,211,
78,Zach Melton,38631,992,+8,69,69,74,212,
78,Allan Kask,121962,973,+8,67,68,77,212,
80,Isaac Heinen,44919,1014,+9,66,77,70,213,
80,Jacob Courtis,56511,1002,+9,75,67,71,213,
80,Courage Davis,121902,991,+9,69,71,73,213,
83,Parker Welck,39491,1015,+11,70,70,75,215,
83,Gavin Phillips,119504,1001,+11,74,68,73,215,
85,Cade Kohlmeier,177319,971,+12,72,75,69,216,
85,Joey Temali,100818,1009,+12,74,69,73,216,
85,Jordan Renzelman,73362,982,+12,66,77,73,216,
85,Kevin Babbit,11110,994,+12,70,71,75,216,
85,Nick Anderson,53889,980,+12,68,71,77,216,
90,Isaiah Esquivel,77939,974,+13,73,67,77,217,
90,Tristan Tanner,99053,1009,+13,70,70,77,217,
90,Noah Fiveash,99153,975,+13,73,75,69,217,
90,Jake Wolff,144536,1006,+13,70,78,69,217,
90,Ryan Orton,31364,993,+13,69,73,75,217,
90,Bruce Esquivel,44600,974,+13,67,68,82,217,
96,Jake Lauber,44782,1004,+16,73,67,80,220,
97,Troy Smart,129319,945,+21,79,71,75,225,
97,Hayden Frederiksen,205985,991,+21,73,74,78,225,
99,Taegen Wells,171247,982,+22,74,78,74,226,
100,Hugo Dwyer,131039,966,+29,80,75,78,233,
101,Jordan Lee,84263,972,+31,80,78,77,235,
102,Scott Adams,68481,986,+33,69,74,94,237,
103,Joe Carey,73855,960,+41,74,84,87,245,
105,Cole Redalen,79748,1039,70,74,888,DNF,,
105,Nikko Locastro,11534,1025,69,76,888,DNF,,
104,Bradley Williams,31644,1031,999,DNF,,,,
107,Matt Bell,48950,1026,68,80,999,DNF,,
