1,Gannon Buhr,75412,1058,-42,55,50,51,156,"$10,000"
2,Corey Ellis,44512,1032,-31,56,54,57,167,"$6,000"
3,Carter Ahrens,88279,1010,-28,59,58,53,170,"$3,501"
3,Anthony Barela,44382,1044,-28,60,55,55,170,"$3,501"
5,Silas Schultz,79047,1020,-27,61,54,56,171,"$2,400"
6,Noah Meintsma,56555,1026,-26,62,55,55,172,"$1,875"
6,Calvin Heimburg,45971,1045,-26,59,56,57,172,"$1,875"
8,Richard Wysocki,38008,1053,-25,62,60,51,173,"$1,575"
8,Sullivan Tipton,78817,1031,-25,57,58,58,173,"$1,575"
10,Ezra Aderhold,121715,1027,-24,62,56,56,174,"$1,225"
10,Robert Burridge,96512,1025,-24,60,58,56,174,"$1,225"
12,Simon Lizotte,8332,1037,-23,62,58,55,175,"$1,075"
12,Mason Ford,72844,1033,-23,61,56,58,175,"$1,075"
14,Andrew Presnell,63765,1030,-22,65,56,55,176,"$1,025"
15,Peter Calabrese,137471,1025,-20,62,56,60,178,$960
15,Andrew Marwede,75590,1033,-20,60,58,60,178,$960
17,Adam Hammes,57365,1034,-19,65,58,56,179,$813
17,Paul Ulibarri,27171,1029,-19,62,59,58,179,$813
17,Lucas Carmichael,151146,1010,-19,60,61,58,179,$813
17,Evan Smith,101574,1044,-19,61,59,59,179,$813
21,Austin Turner,54049,1036,-18,62,62,56,180,$647
21,Harry Chace,131546,1023,-18,63,59,58,180,$647
21,Parker Welck,39491,1026,-18,62,60,58,180,$647
21,Jake Monn,98722,1029,-18,61,60,59,180,$647
21,Nikko Locastro,11534,1024,-18,63,57,60,180,$647
26,Jake Hebenheimer,43762,1025,-17,64,63,54,181,$585
26,Joey Buckets,122356,1032,-17,63,61,57,181,$585
28,Cale Leiviska,24341,1034,-16,65,59,58,182,$550
28,Zachary Nash,101197,1022,-16,63,61,58,182,$550
28,Matthew Orum,18330,1038,-16,60,64,58,182,$550
28,Luke Taylor,102119,1032,-16,65,57,60,182,$550
28,Chris Clemons,50401,1020,-16,63,59,60,182,$550
33,Chris Dickerson,62467,1041,-15,67,61,55,183,$490
33,Eagle McMahon,37817,1034,-15,65,62,56,183,$490
33,Cole Redalen,79748,1031,-15,64,63,56,183,$490
33,Benjamin Callaway,39015,1023,-15,63,63,57,183,$490
33,Nicholas Gill,33838,1014,-15,64,59,60,183,$490
33,Albert Tamm,76669,1020,-15,64,58,61,183,$490
33,Silver LÃ¤tt,61186,1017,-15,63,59,61,183,$490
40,Bradley Williams,31644,1033,-14,66,59,59,184,$445
40,Ty Love,89959,1027,-14,63,62,59,184,$445
42,Nathan Queen,68286,1023,-13,62,64,59,185,$425
42,Garett Everson,98164,1008,-13,62,58,65,185,$425
44,Garrett Gurthie,13864,1020,-12,67,63,56,186,$201
44,Paul Krans,132521,1025,-12,69,59,58,186,$201
44,Evan Walker,190731,1018,-12,68,59,59,186,$201
44,Gregg Barsby,15857,1025,-12,62,57,67,186,$201
48,Colin Bryant,130709,1019,-11,71,60,56,187,
48,Luke Samson,59419,1012,-11,67,64,56,187,
50,Jeremy Koling,33705,1015,-10,68,60,60,188,
51,Gavin Babcock,80331,1030,-9,68,61,60,189,
51,Andrew Miranda,118426,1023,-9,64,59,66,189,
53,Paul Oman,34344,1021,-8,72,58,60,190,
54,Dawson Snelling,45739,1010,-7,67,66,58,191,
54,Matthew Alexander,138103,1009,-7,74,58,59,191,
54,Jacob Blair,52785,1013,-7,64,61,66,191,
57,Trevon Crowe,67172,1004,-6,68,62,62,192,
57,Jonathan Fletcher,65940,1001,-6,65,63,64,192,
59,Gavin Phillips,119504,1019,-5,73,64,56,193,
59,Jaden Rye,153363,1021,-5,73,61,59,193,
59,Braeden Sides,129963,1023,-5,67,66,60,193,
59,Lucas Oberholtzer Hess,90439,1023,-5,67,63,63,193,
63,John Jones,43834,1000,-4,66,67,61,194,
63,Chandler Kramer,139228,1019,-4,66,65,63,194,
65,AJ Carey,61770,1015,-3,70,65,60,195,
66,Jason Lawson,165807,1006,-2,69,65,62,196,
66,Jared Stoll,68103,1001,-2,68,65,63,196,
68,Blake Freeman,180774,979,-1,71,66,60,197,
68,Colten Montgomery,35876,1004,-1,72,64,61,197,
68,Randy Dueck,139619,999,-1,69,64,64,197,
68,Payton Mergen,239942,990,-1,63,70,64,197,
72,Chris Kelley,206380,987,E,66,66,66,198,
73,Bo McLaughlin,87143,1006,+1,73,66,60,199,
73,"Tony ""Candy Arms"" Cahill",53637,983,+1,65,72,62,199,
75,Corbin Milchesky,153445,994,+2,75,66,59,200,
75,Mitchell Privette,44938,996,+2,69,66,65,200,
75,Zach Arlinghaus,65266,1019,+2,69,63,68,200,
78,Jacob Courtis,56511,1007,+3,74,65,62,201,
78,Evan Scott,89394,1024,+3,74,62,65,201,
80,Timothy T3J Johnson Jr,59661,1002,+4,73,69,60,202,
80,Calvin Lonnquist,145206,1012,+4,71,70,61,202,
80,Connor O'Reilly,99648,1006,+4,69,64,69,202,
83,Andy Wacha,70581,993,+5,69,67,67,203,
83,Bonner Butler,61104,996,+5,68,68,67,203,
85,Kelsea Shult-Lewis,230591,979,+7,70,67,68,205,
85,Anders Lind,137292,991,+7,75,61,69,205,
87,Jake Brown,140954,1012,+8,79,66,61,206,
87,Donovan Stein,137733,1001,+8,72,72,62,206,
87,Alex Mier,138269,963,+8,73,69,64,206,
87,Zach Melton,38631,1002,+8,70,65,71,206,
91,Casey White,81739,1030,+9,75,66,66,207,
91,Bryce Harvey,46967,994,+9,73,67,67,207,
91,Luke Humphries,69424,1016,+9,68,71,68,207,
94,Aidan Guthrie,96832,993,+10,71,73,64,208,
95,Caleb Bruce,101944,1001,+11,77,64,68,209,
96,Jake Lauber,44782,1004,+12,72,71,67,210,
97,Brady Harbinson,150967,972,+13,79,68,64,211,
98,Anthony Erickson,56609,979,+15,75,73,65,213,
98,Travis Stevens,125915,990,+15,74,71,68,213,
98,Nathan Welker,134758,972,+15,72,70,71,213,
101,Sam Moyer,135562,967,+18,72,72,72,216,
102,Zack Mullin,100986,972,+21,76,75,68,219,
103,Jacob Bintliff,196686,975,+25,76,72,75,223,
104,PJ Lenz,171559,966,+29,84,73,70,227,
104,Daniel Polk,27276,1008,+29,83,73,71,227,
104,Jordan Cisewski,209645,969,+29,78,73,76,227,
107,Greg Barber,156856,959,+33,78,79,74,231,
108,Brennan Billow,49585,975,73,76,999,DNF,,
108,Kyle Klein,85132,1045,69,999,DNF,,,
108,Ryan Sheldon,87836,1035,999,DNF,,,,
108,Joseph Calabrese,137470,1019,999,DNF,,,,
