1,Gannon Buhr,75412,1056,-24,53,58,32,143,"$11,500"
2,Richard Wysocki,38008,1052,-20,60,58,29,147,"$6,500"
3,Paul McBeth,27523,1044,-18,60,58,31,149,"$4,000"
4,Gavin Rathbun,60436,1028,-16,60,60,31,151,"$3,400"
5,Kyle Klein,85132,1042,-14,59,60,34,153,"$2,800"
6,Isaac Robinson,50670,1046,-13,62,62,30,154,"$2,117"
6,Calvin Heimburg,45971,1045,-13,62,61,31,154,"$2,117"
6,Chris Dickerson,62467,1045,-13,63,58,33,154,"$2,117"
9,Joey Buckets,122356,1032,-12,62,61,32,155,"$1,625"
9,Eagle McMahon,37817,1030,-12,61,61,33,155,"$1,625"
11,Sullivan Tipton,78817,1030,-11,63,64,29,156,"$1,281"
11,Bradley Williams,31644,1033,-11,64,61,31,156,"$1,281"
11,Harry Chace,131546,1021,-11,64,60,32,156,"$1,281"
11,Ezra Aderhold,121715,1027,-11,60,59,37,156,"$1,281"
15,Anthony Barela,44382,1043,-10,63,61,33,157,"$1,075"
16,Matthew Orum,18330,1037,-7,63,65,32,160,$972
16,Joel Freeman,69509,1032,-7,63,63,34,160,$972
16,Jesse Nieminen,58923,1018,-7,62,64,34,160,$972
19,Paul Ulibarri,27171,1032,-6,66,64,31,161,$812
19,Aaron Gossage,35449,1033,-6,67,61,33,161,$812
19,Casey White,81739,1030,-6,63,62,36,161,$812
19,Austin Turner,54049,1034,-6,62,62,37,161,$812
19,Paul Krans,132521,1023,-6,62,62,37,161,$812
24,Mason Ford,72844,1034,-5,64,67,31,162,$674
24,Cole Redalen,79748,1030,-5,63,67,32,162,$674
24,Väinö Mäkelä,59635,1028,-5,65,64,33,162,$674
24,Eric Oakley,53565,1020,-5,62,66,34,162,$674
24,Ezra Robinson,50671,1046,-5,60,67,35,162,$674
29,Andrew Presnell,63765,1031,-4,64,70,29,163,$595
29,Colten Montgomery,35876,1002,-4,66,67,30,163,$595
29,Luke Taylor,102119,1029,-4,67,62,34,163,$595
32,Nicholas Gill,33838,1012,-3,68,64,32,164,$555
32,Ryan Monn,144929,1018,-3,62,64,38,164,$555
34,Connor Rock,73695,1022,-2,68,65,32,165,$473
34,Linus Carlsson,82098,1020,-2,64,69,32,165,$473
34,Gavin Babcock,80331,1032,-2,71,61,33,165,$473
34,Parker Welck,39491,1025,-2,68,64,33,165,$473
34,AJ Carey,61770,1014,-2,67,65,33,165,$473
34,Eli Swansen,128050,999,-2,67,65,33,165,$473
34,Robert Burridge,96512,1027,-2,65,67,33,165,$473
34,Albert Tamm,76669,1021,-2,69,61,35,165,$473
34,Alden Harris,98091,1023,-2,67,63,35,165,$473
43,Kevin Jones,41760,1023,-1,69,67,30,166,$133
43,Ryan Mulder,111887,1006,-1,67,69,30,166,$133
43,Silas Schultz,79047,1020,-1,68,63,35,166,$133
46,Zachary Nash,101197,1020,E,69,67,31,167,
46,Jake Monn,98722,1027,E,63,73,31,167,
46,Carter Ahrens,88279,1010,E,70,65,32,167,
46,Kristian Kuoksa,107078,1016,E,68,66,33,167,
46,Chris Clemons,50401,1021,E,67,67,33,167,
51,Lucas Carmichael,151146,1005,+1,70,68,30,168,
51,Braeden Sides,129963,1021,+1,69,69,30,168,
51,James Conrad,17295,1024,+1,69,67,32,168,
51,Corbin Milchesky,153445,994,+1,65,71,32,168,
51,Jacob Courtis,56511,1002,+1,62,74,32,168,
51,John Jones,43834,1004,+1,70,65,33,168,
51,Chandler Kramer,139228,1021,+1,66,68,34,168,
51,Jake Hebenheimer,43762,1026,+1,62,71,35,168,
59,Wyatt Mahoney,89460,1014,+2,69,69,31,169,
59,Joona Heinänen,58926,1030,+2,67,69,33,169,
59,Luke Humphries,69424,1021,+2,66,70,33,169,
59,Matthew Alexander,138103,1007,+2,66,66,37,169,
63,Zach Arlinghaus,65266,1017,+3,69,69,32,170,
63,Zach Melton,38631,1001,+3,66,72,32,170,
63,Teemu Talikainen,155087,1018,+3,71,65,34,170,
63,Benjamin Callaway,39015,1026,+3,67,69,34,170,
63,Trevon Crowe,67172,1003,+3,71,64,35,170,
63,Andrew Marwede,75590,1031,+3,67,68,35,170,
69,Raven Newsom,88212,1026,+4,72,68,31,171,
69,Garrett Gurthie,13864,1025,+4,72,65,34,171,
69,Randy Dueck,139619,1001,+4,72,65,34,171,
69,G.T. Hancock,49885,1018,+4,70,67,34,171,
69,Evan Scott,89394,1021,+4,67,69,35,171,
74,Nikko Locastro,11534,1023,+5,72,69,31,172,
74,Nathan Queen,68286,1023,+5,68,71,33,172,
74,Connor O'Reilly,99648,1006,+5,68,71,33,172,
74,Fredy Meza,100497,1021,+5,66,73,33,172,
74,Gavin Phillips,119504,1017,+5,64,74,34,172,
74,Michael Babbitt,86291,989,+5,74,63,35,172,
74,Ty Love,89959,1027,+5,71,65,36,172,
81,Luke Samson,59419,1010,+7,72,70,32,174,
81,Charles Peters,107518,981,+7,68,71,35,174,
83,Payton Mergen,239942,984,+8,71,69,35,175,
83,Adam Hammes,57365,1036,+8,69,71,35,175,
83,Teemu Lampainen,107567,1016,+8,68,72,35,175,
83,Jake Brown,140954,1017,+8,70,68,37,175,
87,Andrew Fish,58320,1011,+9,66,75,35,176,
88,Bonner Butler,61104,997,+10,71,73,33,177,
88,Bo McLaughlin,87143,1006,+10,66,78,33,177,
88,Justin Rosak,98161,1004,+10,70,72,35,177,
91,Dillon Spellman,103705,980,+12,77,68,34,179,
92,Brendan Orwig,80347,987,+13,74,70,36,180,
93,Calvin Lonnquist,145206,1013,+14,69,78,34,181,
94,Jonathan Fletcher,65940,1003,+15,70,75,37,182,
94,Jason Lawson,165807,1006,+15,72,72,38,182,
96,Edwin Sieniarecki,117244,986,+20,76,75,36,187,
97,Nick Pascuzzi,196825,979,+21,75,76,37,188,
97,Landon Brooks,83848,983,+21,72,79,37,188,
99,Hugo Dwyer,131039,966,+22,79,74,36,189,
99,Anthony Bodanza,210763,988,+22,74,79,36,189,
101,Chancey Green,61166,978,+24,79,71,41,191,
102,Jared Stoll,68103,1005,+27,69,80,45,194,
103,Dylan Lloyd,152518,978,+28,86,74,35,195,
104,Dick Parker,20250,956,+30,81,79,37,197,
105,Gregg Barsby,15857,1026,72,71,999,DNF,,
106,Gideon Drake,74465,1005,77,999,DNF,,,
106,Scott Adams,68481,992,79,999,DNF,,,
